4
5
2NN2NN3NN4NN
1NN2NN2NN5NN
1NN1SN1KN1NN
3NN1TN1NN1NN
2NN1NH1NN1NN