8
8
2NN1HN4NN1NN1NN3NN1HN2NN
1HN0NN1NN5NN1NN1NN0NN1HN
4NN1NN1NN1NN1NN1NN1NN3NN
1NN1NH1NN1KN1KN1NN1NN1NN
1NN1NN1NN1MN1NN1MN1NN1NN
4NN1NN1MN1NN1MN1NN1NN3NN
1HN0NN1NN5NN1NN1NN0NN1NH
2NN1HN4NN1NN1NN3NN1NO2NN