8
8
0NN0NN0NN0NN0NN0NN0NN0NN
0NN3NH1NN2NO1NN1NN1NN0NN
0NN1NN1NN1NN1NN1NN1NN0NN
0NN4NH1NN1AN1NN1NN1NN0NN
0NN1NN1NN1NN1NN1SN1NN0NN
0NN1NN1NN1NN1SN1NN1NN0NN
0NN1NN1NN1NN1NN1NN1NN0NN
0NN0NN0NN0NN0NN0NN0NN0NN